"Tanggal","ID.Prasarana","Prasarana","Penumpang.Berangkat","Penumpang.Berangkat.Domestik","Penumpang.Berangkat.Internasional","Penumpang.Tiba","Penumpang.Tiba.Domestik","Penumpang.Tiba.Internasional","Pesawat.Tiba.Domestik","Pesawat.Tiba.Internasional","Pesawat.Berangkat.Domestik","Pesawat.Berangkat.Internasional"
"2023-08-19","BPN","Sepinggan",6222,6030,192,5575,5575,0,57,1,54,3
"2023-08-20","BPN","Sepinggan",6758,6606,152,7198,7018,180,56,2,61,2
"2023-08-21","BPN","Sepinggan",6542,6362,180,7616,7496,120,62,1,61,2
"2023-08-22","BPN","Sepinggan",7400,7400,0,6643,6643,0,64,1,61,2
"2023-08-23","BPN","Sepinggan",7196,6900,296,7210,6774,436,59,4,58,3
"2023-08-24","BPN","Sepinggan",6663,6663,0,6333,6333,0,63,1,61,1
"2023-08-25","BPN","Sepinggan",6754,6645,109,6400,6228,172,65,2,63,3
"2023-08-26","BPN","Sepinggan",6897,6711,186,6414,6414,0,59,3,57,3
"2023-08-27","BPN","Sepinggan",6753,6594,159,7222,7045,177,58,2,61,3
"2023-08-28","BPN","Sepinggan",6066,5888,178,7106,7025,81,60,1,61,2
"2023-08-29","BPN","Sepinggan",5918,5918,0,6020,6020,0,62,1,66,1
"2023-08-30","BPN","Sepinggan",7205,6917,288,7375,6954,421,68,4,61,2
"2023-08-31","BPN","Sepinggan",6607,6607,0,6494,6494,0,61,1,63,2
"2023-09-01","BPN","Sepinggan",6803,6713,90,6751,6572,179,66,2,61,1
"2023-09-02","BPN","Sepinggan",6492,6293,199,6432,6429,3,61,2,61,3
"2023-09-03","BPN","Sepinggan",6590,6427,163,7182,7036,146,61,2,62,2
"2023-09-04","BPN","Sepinggan",6000,5820,180,6963,6850,113,66,1,63,3
"2023-09-05","BPN","Sepinggan",6053,6053,0,6344,6344,0,61,1,57,2
"2023-09-06","BPN","Sepinggan",6798,6487,311,8243,7842,401,67,5,64,4
"2023-09-07","BPN","Sepinggan",6446,6446,0,6099,6099,0,60,1,57,2
"2023-09-08","BPN","Sepinggan",6949,6773,176,6813,6649,164,67,2,67,3
"2023-09-09","BPN","Sepinggan",6078,5900,178,6294,6294,0,61,1,60,3
"2023-09-10","BPN","Sepinggan",6333,6224,109,7046,6932,114,60,2,62,2
"2023-09-11","BPN","Sepinggan",5989,5820,169,6978,6903,75,68,1,70,3
"2023-09-12","BPN","Sepinggan",5853,5853,0,6148,6148,0,63,1,61,2
"2023-09-13","BPN","Sepinggan",7407,7170,237,7331,6912,419,66,4,66,4
"2023-09-14","BPN","Sepinggan",6707,6707,0,5954,5954,0,59,1,60,2
"2023-09-15","BPN","Sepinggan",7335,7216,119,6622,6444,178,74,2,68,2
"2023-09-16","BPN","Sepinggan",6170,6011,159,6103,6103,0,59,1,59,2
"2023-09-17","BPN","Sepinggan",6706,6615,91,7596,7459,137,61,2,63,2
"2023-09-18","BPN","Sepinggan",6143,5994,149,7345,7256,89,66,1,68,1
"2023-09-19","BPN","Sepinggan",5777,5777,0,6464,6464,0,64,1,61,2
"2023-09-20","BPN","Sepinggan",7451,7194,257,7537,7176,361,66,4,66,4
"2023-09-21","BPN","Sepinggan",6617,6617,0,6392,6392,0,70,2,62,2
"2023-09-22","BPN","Sepinggan",6865,6760,105,6421,6245,176,68,2,67,2
"2023-09-23","BPN","Sepinggan",6817,6636,181,6345,6345,0,58,1,65,2
"2023-09-24","BPN","Sepinggan",7057,6889,168,6832,6700,132,58,2,60,2
"2023-09-25","BPN","Sepinggan",6580,6408,172,6800,6696,104,60,1,60,2
"2023-09-26","BPN","Sepinggan",6020,6020,0,5138,5138,0,57,2,56,3
"2023-09-27","BPN","Sepinggan",5468,5113,355,5086,4869,217,54,4,53,2
"2023-09-28","BPN","Sepinggan",6914,6914,0,6659,6659,0,58,1,58,1
"2023-09-29","BPN","Sepinggan",5778,5641,137,6324,6153,171,64,2,60,3
"2023-09-30","BPN","Sepinggan",5830,5821,9,6056,6056,0,59,1,55,3
"2023-10-01","BPN","Sepinggan",7837,7703,134,8195,8019,176,63,2,66,3
"2023-10-02","BPN","Sepinggan",6660,6482,178,7640,7516,124,68,1,68,3
"2023-10-03","BPN","Sepinggan",6012,6012,0,6291,6291,0,60,1,60,1
"2023-10-04","BPN","Sepinggan",7587,7301,286,8586,8346,240,67,3,67,5
"2023-10-05","BPN","Sepinggan",7284,7284,0,7085,6578,507,61,3,62,1
"2023-10-06","BPN","Sepinggan",7439,7300,139,6376,6231,145,16541,2,64,1
"2023-10-07","BPN","Sepinggan",6300,6300,0,6311,6311,0,62,1,59,3
"2023-10-08","BPN","Sepinggan",7104,6947,157,7744,7627,117,63,2,66,2
"2023-10-09","BPN","Sepinggan",6236,6085,151,7658,7534,124,61,1,61,2
"2023-10-10","BPN","Sepinggan",6628,6628,0,6610,6610,0,61,1,60,2
"2023-10-11","BPN","Sepinggan",7812,7514,298,7393,7191,202,71,3,68,4
"2023-10-12","BPN","Sepinggan",7709,7709,0,6668,6668,0,60,1,61,2
"2023-10-13","BPN","Sepinggan",7757,7621,136,6335,6154,181,63,2,59,2
"2023-10-14","BPN","Sepinggan",6160,6160,0,6607,6607,0,53,1,55,1
"2023-10-15","BPN","Sepinggan",7015,6887,128,7641,7464,177,61,3,63,2
"2023-10-16","BPN","Sepinggan",6511,6330,181,7571,7463,108,65,1,64,4
"2023-10-17","BPN","Sepinggan",6138,6138,0,6899,6899,0,56,1,55,1
"2023-10-18","BPN","Sepinggan",7552,7259,293,7421,7249,172,62,3,63,4
"2023-10-19","BPN","Sepinggan",6972,6972,0,6450,6450,0,62,1,63,1
"2023-10-20","BPN","Sepinggan",7548,7374,174,6794,6637,157,66,2,64,4
"2023-10-21","BPN","Sepinggan",5861,5858,3,6148,6148,0,52,2,51,2
"2023-10-22","BPN","Sepinggan",6330,6150,180,7668,7494,174,60,2,63,2
"2023-10-23","BPN","Sepinggan",6489,6311,178,7517,7394,123,66,1,64,3
"2023-10-24","BPN","Sepinggan",6252,6252,0,6253,6253,0,54,1,55,2
"2023-10-25","BPN","Sepinggan",7732,7437,295,7491,7269,222,64,3,62,2
"2023-10-26","BPN","Sepinggan",8761,8761,0,7314,7313,1,58,2,61,2
"2023-10-27","BPN","Sepinggan",7112,6958,154,7174,6995,179,63,2,60,2
"2023-10-28","BPN","Sepinggan",6580,6580,0,7750,7750,0,58,1,56,1
"2023-10-29","BPN","Sepinggan",6464,6290,174,6712,6544,168,52,2,53,1
"2023-10-30","BPN","Sepinggan",6836,6684,152,7966,7827,139,67,1,65,3
"2023-10-31","BPN","Sepinggan",5838,5838,0,6717,6717,0,66,1,62,2
"2023-11-01","BPN","Sepinggan",7150,6858,292,7230,6964,266,60,3,59,3
"2023-11-02","BPN","Sepinggan",7761,7761,0,6976,6976,0,63,1,61,2
"2023-11-03","BPN","Sepinggan",7879,7714,165,6496,6322,174,68,2,64,2
"2023-11-04","BPN","Sepinggan",6460,6460,0,6389,6389,0,60,1,65,3
"2023-11-05","BPN","Sepinggan",6511,6338,173,7494,7339,155,55,2,56,2
"2023-11-06","BPN","Sepinggan",6768,6596,172,7950,7778,172,64,1,64,2
"2023-11-07","BPN","Sepinggan",6174,6174,0,6377,6377,0,52,1,52,2
"2023-11-08","BPN","Sepinggan",7385,7061,324,7191,7000,191,55,3,54,2
"2023-11-09","BPN","Sepinggan",7617,7617,0,6713,6713,0,55,1,57,0
"2023-11-10","BPN","Sepinggan",7663,7523,140,7226,7057,169,64,2,62,2
"2023-11-11","BPN","Sepinggan",5738,5738,0,6523,6523,0,54,2,53,1
"2023-11-12","BPN","Sepinggan",6566,6452,114,7972,7787,185,58,2,61,2
"2023-11-13","BPN","Sepinggan",6759,6589,170,7947,7813,134,63,1,67,2
"2023-11-14","BPN","Sepinggan",6053,6053,0,5956,5956,0,59,1,61,0
"2023-11-15","BPN","Sepinggan",7879,7601,278,7733,7450,283,64,3,64,3
"2023-11-16","BPN","Sepinggan",7720,7720,0,7321,7321,0,64,0,64,0
"2023-11-17","BPN","Sepinggan",7295,7148,147,7119,6949,170,61,2,61,1
"2023-11-18","BPN","Sepinggan",6194,6194,0,7087,7078,9,67,2,65,2
"2023-11-19","BPN","Sepinggan",6960,6802,158,8346,8169,177,67,2,69,3
"2023-11-20","BPN","Sepinggan",7232,7051,181,8481,8350,131,77,1,79,2
"2023-11-21","BPN","Sepinggan",5863,5863,0,5957,5957,0,57,1,57,1
"2023-11-22","BPN","Sepinggan",7305,7011,294,7168,6938,230,58,3,55,4
"2023-11-23","BPN","Sepinggan",7102,7102,0,6876,6876,0,60,1,60,1
"2023-11-24","BPN","Sepinggan",7741,7603,138,6904,6729,175,67,2,64,2
"2023-11-25","BPN","Sepinggan",6451,6451,0,7681,7681,0,60,1,58,1
"2023-11-26","BPN","Sepinggan",7418,7304,114,8166,8008,158,66,2,69,2
"2023-11-27","BPN","Sepinggan",7552,7393,159,8489,8372,117,68,1,68,2
"2023-11-28","BPN","Sepinggan",6072,6072,0,6517,6517,0,62,1,64,1
"2023-11-29","BPN","Sepinggan",6937,6693,244,6777,6550,227,65,3,65,3
"2023-11-30","BPN","Sepinggan",7517,7517,0,6697,6697,0,62,1,65,1
"2023-12-01","BPN","Sepinggan",6909,6764,145,6999,6821,178,63,2,61,2
"2023-12-02","BPN","Sepinggan",5450,5450,0,5915,5915,0,58,1,64,1
"2023-12-03","BPN","Sepinggan",6313,6313,0,6850,6850,0,52,1,58,1
"2023-12-04","BPN","Sepinggan",6038,5867,171,7399,7240,159,60,1,58,1
"2023-12-05","BPN","Sepinggan",5936,5936,0,5879,5879,0,54,1,52,3
"2023-12-06","BPN","Sepinggan",7623,7348,275,7275,7039,236,58,3,60,2
"2023-12-07","BPN","Sepinggan",7175,7175,0,6443,6443,0,56,1,56,0
"2023-12-08","BPN","Sepinggan",7720,7558,162,6699,6519,180,62,3,62,2
"2023-12-09","BPN","Sepinggan",6607,6607,0,6952,6952,0,57,1,53,2
"2023-12-10","BPN","Sepinggan",7938,7777,161,7694,7529,165,55,2,60,2
"2023-12-11","BPN","Sepinggan",6936,6758,178,7220,7171,49,59,1,60,1
